
11111111111111111111111
100000000000000000000001
10p00000000000000000000111
100000000000000000000000w1
11111111111111111111111111
